S ########
# #      #
# ### ## #
# #    # #
#    # # #
# ########
# #      #
# # #  # #
##### # ##
#   #    E
# #    # #
##########